
      #####
      #   ##
    ###    #
    #. #$$ #
    #     ##
    #.  $##
######.   #####
# ..## ## #  .#
# $    ## $ # #
#  #$# ## *$  #
#   .$ ## .#  #
##### ###    ##
    # # #   ##
    # ### ###
    #.  @.#
    #  $# ##
    # # $. #
    #   $# #
    ####   #
       #####
; Level 2